question	answer
Ok, thanks	You're welcome
Who are you? What is your name?	I am an AI assistant running on Synaptics Astra SL 16 80
My dishwasher won't start.	If your dishwasher isn't starting, check that it's plugged in, the circuit breaker hasn't tripped, the door is fully closed, and the Power button is activated.
The applicance will not power on	If your dishwasher isn't starting, check that it's plugged in, the circuit breaker hasn't tripped, the door is fully closed, and the Power button is activated.
It won't start.	Ensure the appliance is connected to power, the door latch is engaged, and you've pressed the Start button to initiate the cycle.
Dishwasher won't start.	Verify that the dishwasher is properly plugged in, the door is securely shut, and the control panel is responsive.
My dishwasher is leaking.	If you notice water leaking, inspect the door gasket for damage or debris, and make sure dishes aren't obstructing the door closure.
It is leaking.	A leak could be due to a worn-out door seal; clean it gently and check for any signs of wear or damage.
Dishwasher is leaking.	Ensure that the dishwasher is level, and examine the hoses and connections for any leaks or loose fittings.
My dishes aren't getting clean.	If dishes are coming out dirty, make sure the spray arms are not clogged and can rotate freely. Also, check that you're using the correct amount of detergent.
It isn't washing properly.	Confirm that the dishwasher isn't overloaded, the spray arms are clean, and you're selecting the appropriate wash cycle for your load.
Dishes are still dirty.	Ensure that dishes are properly loaded without blocking the spray arms, and that the filter is clean to allow proper water circulation.
How do I install the dishwasher?	Place the dishwasher on a flat surface, connect it to the cold water supply. Leave at least 5 cm of space around it for ventilation, and plug it into an accessible power outlet.
How do I connect the dishwasher to the water supply?	Attach the inlet hose to the cold water tap, ensuring it's securely connected to both the tap and the dishwasher's inlet valve. Check for any leaks before operating.
How do I turn the dishwasher on?	Press the Power button located on the control panel. The display should light up, indicating that the dishwasher is ready for cycle selection.
How do I select a wash cycle?	Use the Program Selector button to browse through available cycles.
What wash cycles are available?	Available wash cycles are Normal Wash, Heavy Wash, Quick Wash, Eco Wash, and Rinse Only
How do I load the dishwasher?	Place plates, glasses, and utensils in their designated racks. Ensure that items do not block the spray arms and that larger items are placed at the sides or back.
How do I add detergent?	Open the detergent dispenser compartment, add the recommended amount of dishwasher detergent based on the cycle and water hardness, and close the compartment securely.
How do I start a wash cycle?	After loading dishes and selecting your wash program, press the Start button. The door will lock, and the dishwasher will begin the cycle.
What should I do at the end of the wash cycle?	When the cycle completes, the dishwasher will signal with a beep. You can then open the door to allow steam to escape and let the dishes cool before unloading.
How do I clean the filter?	Remove the bottom rack to access the filter. Twist and lift it out, rinse under warm water to remove debris, and reinstall it by aligning and twisting it back into place.
How do I clean the spray arms?	Detach the upper and lower spray arms by unscrewing them. Rinse under running water to remove any blockages, then reattach them securely.
What should I do if the dishwasher does not start?	Check that the power cord is plugged in, the door is properly latched, the water supply is turned on, and that you've selected a wash cycle and pressed Start.
What should I do if the dishwasher is not draining?	Inspect the drain hose for kinks or blockages, and check that the filter and garbage disposal (if connected) are clean.
What is the support number?	For any assistance, please contact our customer service at 1 800 1 2 3 45 67.
How long is the warranty?	Our dishwasher comes with a 2-year limited warranty covering parts and labor under normal residential use.
How do I adjust the top rack?	Locate the adjustment levers on either side of the upper rack. Lift them to raise or lower the rack to accommodate taller items.
Can I wash plastic items?	Yes, but only place dishwasher-safe plastics on the top rack to prevent warping from heat.
What detergents are recommended?	We recommend using high-quality automatic dishwasher detergents in powder, liquid, or tablet form.
How do I use the delay start function?	Press the Delay Start button until you reach the desired delay time (1-24 hours), then select your wash cycle and press Start.
The dishwasher is making unusual noises.	Unusual sounds may be caused by items touching the spray arms. Rearrange the dishes to ensure nothing is interfering with their rotation.
The dishes are not drying properly.	Make sure you are using rinse aid to enhance drying, and select a cycle with a drying phase.
The dishwasher has a bad odor.	Run an empty cycle with a dishwasher cleaner or a cup of white vinegar placed on the top rack to eliminate odors.
How do I reset the dishwasher?	To reset, press and hold the Start button for 3 seconds to cancel the current cycle, then select a new cycle if needed.
What does the error code E1 mean?	Error code E1 indicates a water inlet problem. Check that the water supply is on and the inlet hose is not kinked or blocked.
How do I descale the dishwasher?	Use a descaling agent specifically designed for dishwashers and run an empty cycle according to the product instructions.
Can I open the dishwasher during a cycle?	Yes, but open the door carefully to avoid hot steam. The cycle will pause and can be resumed by closing the door and pressing Start.
The dishwasher door won't close.	Check for any obstructions like utensils or large dishes preventing the door from closing fully.
How do I change the language settings?	Access the settings menu by pressing and holding the Program and Delay buttons for 5 seconds, then navigate to language options.
What is the energy consumption of the dishwasher?	The dishwasher uses approximately 1.05 kilowatt hours per cycle, on the standard Normal Wash setting.
How much water does the dishwasher use?	It consumes about 12 liters of water per cycle when using the Normal Wash program.
Can I connect the dishwasher to hot water?	It's recommended to connect to a cold water supply. Connecting to hot water may affect wash performance and energy efficiency.
How do I cancel a running cycle?	Press and hold the Cancel button for 3 seconds. The dishwasher will drain and return to standby mode.
What is the maximum dish size that fits?	With the upper rack adjusted, dishes up to 12 inches in diameter can fit in the lower rack.
How do I use the child lock feature?	Activate the child lock by pressing and holding the Child Lock button for 3 seconds. This will disable the control panel.
Can I use tablet detergents?	Yes, tablet detergents are compatible. Place the tablet in the main detergent dispenser.
The control panel is not responding.	Ensure that the child lock isn't activated. If it is, deactivate it by pressing and holding the Child Lock button for 3 seconds.
How often should I clean the filter?	For optimal performance, clean the filter at least once a month or more frequently if needed.
What materials are not dishwasher-safe?	Avoid washing wood, cast iron, fine china, crystal, and non-dishwasher-safe plastics.
How do I adjust the rinse aid dosage?	Turn the knob inside the rinse aid dispenser to increase or decrease the amount released per cycle.
What is the noise level of the dishwasher?	The dishwasher operates quietly at around 45 decibels.
How do I replace the door seal?	Order a replacement gasket from customer service and follow the instructions provided to remove the old seal and install the new one.
Can I pause a cycle?	Yes, to pause the cycle, simply open the door. Resume by closing the door and pressing the Start button.
What does the salt indicator light mean?	It indicates that the water softener salt reservoir is low. Refill it to ensure optimal cleaning performance.
How do I fill the salt reservoir?	Unscrew the cap of the salt reservoir located at the bottom of the dishwasher and fill it with dishwasher-specific salt using a funnel.
Is pre-rinsing dishes necessary?	Pre-rinsing isn't required. Simply scrape off large food particles before loading.
How do I set the water hardness level?	Refer to the user manual to adjust the water hardness settings via the control panel, based on your local water hardness.
What is the Drying function?	The Drying function uses heat to evaporate moisture, leaving your dishes dry at the end of the cycle.
How do I know when the rinse aid is low?	A rinse aid indicator light on the control panel will illuminate when it's time to refill.
Can I run the dishwasher overnight?	Yes, you can use the Delay Start function to run the dishwasher during off-peak hours or overnight.
How do I clean the exterior of the dishwasher?	Wipe the exterior with a soft cloth dampened with mild soapy water. Avoid abrasive cleaners.
What should I do during a power outage?	The dishwasher will pause during a power outage. Once power is restored, it may resume the cycle or you may need to restart it.
How do I update the dishwasher's software?	If software updates are available, they can be performed via a USB port or Wi-Fi connection, following the instructions in the user manual.
Can I wash non-stick cookware?	While some non-stick items are dishwasher-safe, hand washing is recommended to prolong their lifespan.
How do I dispose of the dishwasher at the end of its life?	Dispose of the appliance according to local electronic waste regulations. Contact your local waste management facility for guidance.
Does the dishwasher have a self-cleaning cycle?	Yes, select the Self-Clean or Machine Care cycle to clean the interior components.
How do I prevent glassware from clouding?	Use a rinse aid and ensure the water hardness setting is correct to prevent mineral deposits on glassware.
Why is there water left in the detergent dispenser?	A small amount of water remaining is normal. If excessive, ensure the dispenser isn't blocked and can open fully during the cycle.
Can I interrupt a cycle to add more dishes?	Yes, open the door carefully to pause the cycle, add the dishes, then close the door and press Start to resume.
What is the maximum load capacity?	The dishwasher can accommodate up to 14 place settings in a single load.
How do I use the eco wash cycle?	Select the Eco Wash cycle from the program options for an energy-efficient wash that conserves water and electricity.
What does the rinse aid do?	Rinse aid helps to reduce water spots and improve drying by causing water to sheet off dishes.
How do I clean the stainless steel interior?	Wipe the interior with a damp cloth or run an empty cycle with a dishwasher cleaner designed for stainless steel interiors.
Can I use vinegar as a rinse aid?	It's not recommended to use vinegar as it can damage the dishwasher's rubber components. Use a commercially available rinse aid instead.
What temperature does the dishwasher reach?	The dishwasher heats water up to 65°C (149°F) during the hottest wash cycle.
How do I know if the wash cycle is complete?	The control panel will display an 'End' message or the dishwasher will emit a series of beeps.
Can I stack dishes?	Avoid stacking dishes as it can prevent proper cleaning. Each item should have access to water spray.
How do I prevent etching on glassware?	Use less detergent, avoid extremely hot water cycles, and remove glassware promptly after the cycle ends.
Why is there standing water in the bottom?	A small amount of water is normal. If excessive, check for clogs in the drain filter or hose.
What is the Quick Wash cycle?	Quick Wash is a shorter cycle ideal for lightly soiled dishes that need a fast turnaround.
How do I care for the exterior finish?	For stainless steel exteriors, use a stainless steel cleaner. For other finishes, use a mild detergent and soft cloth.
Is it safe to wash baby bottles?	Yes, place dishwasher-safe baby bottles on the top rack and use a sanitizing cycle if available.
Can I use bleach in the dishwasher?	Do not use bleach or products containing chlorine as they can damage the dishwasher's components.
How do I remove hard water deposits?	Use a dishwasher cleaner specifically designed to remove limescale and mineral buildup.
Why is the dishwasher not filling with water?	Check that the water supply is turned on, the inlet hose isn't kinked, and the inlet valve filter isn't clogged.
What does the sanitize option do?	The sanitize option increases the water temperature to eliminate 99.9% of bacteria on dishes.
How do I fix a cloudy film on dishes?	Ensure you're using the correct amount of detergent and rinse aid, and check water hardness settings.
Can I wash cookware with non-removable handles?	If the cookware is dishwasher-safe and fits properly, it can be washed. Place it securely to prevent movement.
How do I handle a dishwasher overflow?	Turn off the dishwasher and unplug it. Clean up any spilled water and check for causes like excessive suds or blockages.
What causes a white residue on dishes?	White residue is often due to hard water minerals. Use a rinse aid and adjust the water hardness setting.
Is it normal for steam to come out during operation?	Yes, some steam release is normal, especially during the drying phase.
Can I use pods in the dishwasher?	Yes, dishwasher detergent pods can be placed in the main detergent compartment.
How do I troubleshoot a flashing light on the control panel?	Refer to the user manual for specific error codes associated with flashing lights.
What maintenance does the dishwasher require?	Regularly clean the filter, check spray arms, wipe down seals, and run a cleaning cycle monthly.
Can I wash cutting boards?	Dishwasher-safe cutting boards can be washed, but wooden boards should be hand-washed.
How do I prevent the dishwasher from smelling musty?	Leave the door slightly ajar when not in use to allow air circulation and prevent mold growth.
What is the purpose of the top spray arm?	The top spray arm helps clean items on the upper rack by distributing water evenly.
Why are my silver utensils tarnishing?	Silver can react with certain foods and detergents. Wash silver separately and avoid contact with stainless steel.
How do I load wine glasses?	Place wine glasses securely in the top rack, using stemware holders if available to prevent tipping.
I've tried everything and the dishwasher still won't start. What should I do?	If your dishwasher remains unresponsive after checking the power supply, door latch, and control panel, it may require professional attention. Please contact our customer support at 1-800-123-4567 for further assistance.
This dishwasher constantly leaks and I'm fed up. How can I fix this?	We're sorry to hear about the persistent leaking. This could indicate a faulty component that needs servicing. Please schedule a service appointment by calling us at 1-800-123-4567.
My dishes are always dirty even after multiple cycles. What's the point of this dishwasher?	We apologize for the inconvenience. Consistently dirty dishes may result from an issue with the wash system. Ensure the spray arms are clean and unobstructed, and that you're using the recommended detergent. If the problem persists, please contact our customer service for support.
I've had enough of these issues. How do I get a refund or replacement?	We understand your frustration. For information on refunds or replacements, please review our warranty policy and contact customer service at 1-800-123-4567 to discuss your options.
Your customer service is terrible. How can I speak to a manager?	We're sorry to hear about your experience. Please call our customer service line. We are committed to addressing your concerns.
I am unhappy	Sorry I couldn't help. Please call our customer service line at 1 800 1 2 3 45 67 and request to speak with a supervisor. We are committed to addressing your concerns.
hello	Hello! How can I assist you today?
how are you?	I'm a virtual assistant, so I'm always ready to help. How can I assist you today?
My dishwasher stopped mid-cycle, what do I do?	If the dishwasher stopped mid-cycle, check for a power outage or a tripped breaker. Make sure the door is fully latched and try pressing the Start button to resume.
Why is there a burning smell coming from the dishwasher?	A burning smell may indicate a blocked motor or an object touching the heating element. Stop the dishwasher, inspect for obstructions, and ensure no plastic items are near the heating element.
Why is my dishwasher's detergent door not opening?	If the detergent door doesn't open, ensure the door latch is working and not obstructed. Make sure you're not overloading near the detergent compartment.
Why is my dishwasher still running after hours?	If the dishwasher runs unusually long, check if it's in a heavy wash or sanitizing cycle, which may extend run time. If it seems stuck, try resetting it by holding the Start button for a few seconds.
My dishwasher isn't drying my dishes. Why?	For effective drying, use a rinse aid and select a drying cycle if available. Avoid overloading, as it can block airflow, and open the door after the cycle to release steam.
What's the time?	{time}
What's the weather like?	{weather}
Tell me a joke	{joke}
Show me the system status	{status}
