question	answer	keywords
OK, thank you.	You're welcome	Counter({'okthankyou': 1})
what's the time?	{time}	Counter({'whatsthetime': 1})
Execute dishwasher program	{load_dishwasher}	Counter({'executedishwasherprogram': 1})
Execute mars computer program	{load_mars}	Counter({'executemarscomputerprogram': 1})
Tell me more about this demo?	I am an open-source demo created by Synaptics. I am running efficient speech-to-text and language models entirely on-device.	Counter({'tellmemoreaboutthisdemo': 1})
Where can I learn more about synaptics astra?	You can learn more at developer.synaptics.com.	Counter({'wherecanilearnmoreaboutsynapticsastra': 1})
Who are you? What is your name?	I am an AI assistant running on Synaptics Astra	Counter({'whoareyouwhatisyourname': 1})
How do I start using my dishwasher?	To start using your dishwasher, first place your dirty dishes inside. Make sure not to overcrowd the machine. Then add detergent in the designated area and check if you need to add rinse aid. Close the door and select the desired wash cycle. Finally, press the start button.	Counter({'howdoistartusingmydishwasher': 1})
What type of detergent should I use?	You should use dishwasher detergents that are phosphate-free and specially designed for dishwashers. Tablets and packs are recommended for convenience and better cleaning.	Counter({'whattypeofdetergentshouldiuse': 1})
What is rinse aid and why do I need it?	Rinse aid helps your dishes dry better and prevents hard water spots. It improves washing performance by allowing water to sheet off your dishes instead of forming droplets.	Counter({'whatisrinseaidandwhydoineedit': 1})
How often should I add rinse aid?	You should check the rinse aid dispenser regularly. Fill it whenever it is low to ensure optimal drying performance.	Counter({'howoftenshouldiaddrinseaid': 1})
Can I overload the dishwasher?	It is not a good idea to overload the dishwasher. Always leave enough space for water to circulate around the dishes for proper cleaning.	Counter({'canioverloadthedishwasher': 1})
What should I do if my dishes are still dirty after a wash?	First, check if you are using enough detergent and rinse aid. Ensure the dishes are properly loaded and not blocking the spray arms. Try running the dishwasher on a longer cycle next time.	Counter({'whatshouldidoifmydishesarestilldirtyafterawash': 1})
How do I clean the filters in my dishwasher?	To clean the filters, first remove them from the bottom of the dishwasher. Rinse them under running water to remove any debris. Be sure to do this at least once a month.	Counter({'howdoicleanthefiltersinmydishwasher': 1})
What happens if I don’t use rinse aid?	If you don’t use rinse aid, your dishes may come out with water spots and may not dry properly. This can affect the overall cleaning performance.	Counter({'whathappensifidontuserinseaid': 1})
Is it normal for my dishwasher to run long?	Yes, it is normal for energy-efficient dishwashers to run longer. They pause for soaking and cleaning to save water and energy while providing a better clean.	Counter({'isitnormalformydishwashertorunlong': 1})
Why does my dishwasher have an optical water sensor?	The optical water sensor helps the dishwasher determine the right amount of water and energy needed for optimal cleaning, adjusting the cycle length accordingly.	Counter({'whydoesmydishwasherhaveanopticalwatersensor': 1})
How do I know if I need to clean the filters?	Check your dishes. If they are not coming out clean, it may be a sign that the filters need cleaning. It’s good practice to clean them at least once a month.	Counter({'howdoiknowifineedtocleanthefilters': 1})
What kind of cycles does the dishwasher have?	Your dishwasher has different wash cycles. You can choose based on how dirty your dishes are, like a light wash for lightly soiled dishes or a longer cycle for heavy dirt.	Counter({'whatkindofcyclesdoesthedishwasherhave': 1})
How can I prevent hard water spots on my dishes?	To prevent hard water spots, always use rinse aid, which helps water to roll off dishes instead of leaving spots as it dries.	Counter({'howcanipreventhardwaterspotsonmydishes': 1})
How do I load tall objects like pots and pans?	Load tall items like pots and pans in the lower rack of the dishwasher. Make sure they do not block the spray arms to ensure they get properly cleaned.	Counter({'howdoiloadtallobjectslikepotsandpans': 1})
Can I use regular dish soap in the dishwasher?	No, you should not use regular dish soap in the dishwasher. It will create too many bubbles and can damage the appliance.	Counter({'caniuseregulardishsoapinthedishwasher': 1})
What should I do if the dishwasher smells bad?	Check for leftover food stuck in the filters or at the bottom of the dishwasher. Cleaning the filters and running a cycle with vinegar can help remove odors.	Counter({'whatshouldidoifthedishwashersmellsbad': 1})
How do I fix a leaking dishwasher?	Check the door seal for any cracks or dirt. Make sure the dishwasher is level too, as an uneven position can cause leaks. If the problem continues, contact a professional.	Counter({'howdoifixaleakingdishwasher': 1})
Does the dishwasher use a lot of water?	No, your dishwasher is designed to be water-efficient. It uses less water than washing dishes by hand.	Counter({'doesthedishwasherusealotofwater': 1})
How do I unload the dishwasher?	Unload the dishwasher starting with the bottom rack first to prevent water from dripping onto the clean dishes in the upper rack.	Counter({'howdoiunloadthedishwasher': 1})
How often should I run the dishwasher?	You can run the dishwasher every day if you have enough dirty dishes. Just ensure you are loading it properly to maintain cleaning performance.	Counter({'howoftenshouldirunthedishwasher': 1})
What should I do if I hear unusual noises from the dishwasher?	Check if any dishes are touching the spray arms or if something is stuck in the filter. If noises continue, it may be best to get it checked by a technician.	Counter({'whatshouldidoifihearunusualnoisesfromthedishwasher': 1})
Can I run the dishwasher overnight?	Yes, you can run the dishwasher overnight. Many users choose to do this to take advantage of lower energy rates while they sleep.	Counter({'canirunthedishwasherovernight': 1})
How do I load the dishwasher correctly?	Place larger items, like plates and pots, on the bottom rack. Put smaller items, like cups and glasses, on the top rack. Make sure everything is facing down or inward to catch the water.	Counter({'howdoiloadthedishwashercorrectly': 1})
What can I put in the dishwasher?	You can wash most plates, bowls, silverware, and glasses. Check if items are labeled as dishwasher safe. Avoid washing wooden items or anything that can warp.	Counter({'whatcaniputinthedishwasher': 1})
Where do I put the detergent?	Put the detergent in the dispenser, which is usually on the inside of the door. Make sure to close the lid tightly.	Counter({'wheredoiputthedetergent': 1})
How do I add rinse aid?	Look for the rinse aid dispenser, usually near the detergent section. Open it and pour in the rinse aid until it's full, then close it.	Counter({'howdoiaddrinseaid': 1})
Why are my dishes still dirty after a wash?	Check that you loaded the dishwasher properly. Ensure the spray arms can move freely and are not blocked by any items.	Counter({'whyaremydishesstilldirtyafterawash': 1})
What does the overfill protection float do?	The overfill protection float prevents too much water from filling the dishwasher. It helps keep the water level just right.	Counter({'whatdoestheoverfillprotectionfloatdo': 1})
How can I avoid spots on my dishes?	Use rinse aid. It helps reduce water spots and helps dishes dry better.	Counter({'howcaniavoidspotsonmydishes': 1})
What should I do if the dishwasher is making a loud noise?	It could be that something is loose or not in place. Check if any utensils or dishes are touching the spray arms.	Counter({'whatshouldidoifthedishwasherismakingaloudnoise': 1})
How often should I clean my dishwasher?	It’s good to clean the dishwasher every month. Wipe down the inside and check for food buildup in the filter.	Counter({'howoftenshouldicleanmydishwasher': 1})
Can I run the dishwasher at a low temperature?	Check the settings. Some dishwashers have options for eco or energy-saving washes, but these might take longer.	Counter({'canirunthedishwasheratalowtemperature': 1})
What's the best way to dry my dishes?	Using rinse aid will help. You can also let the dishwasher finish its cycle and then leave the door slightly open to let air in.	Counter({'whatsthebestwaytodrymydishes': 1})
What if the water isn’t draining?	Make sure the drain is not blocked. Check to see if there are any food particles clogging the filter or drain.	Counter({'whatifthewaterisntdraining': 1})
How do I know when to refill the rinse aid?	There’s usually a window on the rinse aid dispenser. When you can’t see any liquid, it’s time to refill it.	Counter({'howdoiknowwhentorefilltherinseaid': 1})
Is it okay to stack silverware in the basket?	Yes, but it should not touch each other. Place forks, knives, and spoons facing down to prevent them from nesting.	Counter({'isitokaytostacksilverwareinthebasket': 1})
What should I do if my dishes smell bad after washing?	Check for food debris stuck in the filter. Clean the filter and run a rinse cycle with vinegar to freshen it up.	Counter({'whatshouldidoifmydishessmellbadafterwashing': 1})
How do I prevent plastic items from melting?	Place plastic items on the top rack. The heating element is usually at the bottom, so they are safer up high.	Counter({'howdoipreventplasticitemsfrommelting': 1})
What do I do if my dishwasher doesn’t start?	Check if it's plugged in and the door is closed tightly. Make sure the cycle settings are selected correctly.	Counter({'whatdoidoifmydishwasherdoesntstart': 1})
Can I wash pots and pans in the dishwasher?	Yes, but make sure they are dishwasher safe. Place them on the bottom rack for better cleaning.	Counter({'caniwashpotsandpansinthedishwasher': 1})
How can I help my dishwasher work better?	Rinse off large food pieces before loading. Don’t overload it and ensure water can flow freely to all items.	Counter({'howcanihelpmydishwasherworkbetter': 1})
What type of detergent should I use?	Use dishwasher-specific detergent. It's made for cleaning dishes and works better than regular soap.	Counter({'whattypeofdetergentshouldiuse': 1})
What features does the upper level wash have?	The upper level wash has a spray arm that helps clean dishes on the top rack. It also includes cup shelves on some models.	Counter({'whatfeaturesdoestheupperlevelwashhave': 1})
How do I adjust the tines in the dishwasher?	Some dishwashers have EZ Adjust tines that can change position. Look for the adjustment mechanism and move them if needed.	Counter({'howdoiadjustthetinesinthedishwasher': 1})
How do I load the dishwasher?	Start by placing dirty dishes in the dishwasher. Make sure to spin the spray arms to see if they turn freely. This helps them clean properly.	Counter({'howdoiloadthedishwasher': 1})
What should I do after loading my dishwasher?	After loading, add dishwasher detergent and rinse aid to their respective compartments.	Counter({'whatshouldidoafterloadingmydishwasher': 1})
How do I choose a washing cycle?	Select a cycle based on how dirty your dishes are. You might have options like Sensor, Heavy, Normal, 1-Hr Wash, or Soak & Clean.	Counter({'howdoichooseawashingcycle': 1})
What are some options I can choose for washing?	You can choose options like Heat Dry, High Temp, Sani Rinse, or set a 4-Hr Delay, if your model has them.	Counter({'whataresomeoptionsicanchooseforwashing': 1})
How do I start the dishwasher?	Select your cycle and any options you want. Then press START/RESUME if your controls are on the top. After that, close the door firmly.	Counter({'howdoistartthedishwasher': 1})
What if I need to cancel a cycle?	Press the Cancel button to stop the current cycle if needed.	Counter({'whatifineedtocancelacycle': 1})
Can I pause the dishwasher during a cycle?	To pause the wash, simply press the Resume button. This can help you check on your dishes.	Counter({'canipausethedishwasherduringacycle': 1})
How do I know when the cycle is done?	The dishwasher will make a sound or the lights will change when the cycle is finished.	Counter({'howdoiknowwhenthecycleisdone': 1})
What do I do after the cycle ends?	Once the cycle is done, open the door and unload the clean dishes. It's also a good time to clean the filter.	Counter({'whatdoidoafterthecycleends': 1})
Where is the filter located?	The filter is usually found at the bottom of the dishwasher. Check your manual for its exact location.	Counter({'whereisthefilterlocated': 1})
How often should I clean the filter?	Check the “Filtration System” section in your manual for the recommended cleaning schedule for the filter.	Counter({'howoftenshouldicleanthefilter': 1})
What if the dishwasher does not start?	Ensure the door is closed tightly and that you've pressed START/RESUME. Also, check if it's plugged in.	Counter({'whatifthedishwasherdoesnotstart': 1})
What can I do if my dishes are still dirty after a wash?	Make sure you loaded the dishes properly and added enough detergent. You might want to try a heavier cycle next time.	Counter({'whatcanidoifmydishesarestilldirtyafterawash': 1})
Can I run the dishwasher with just a few dishes?	It's fine to run it with a few dishes, but make sure they are loaded properly for the best cleaning results.	Counter({'canirunthedishwasherwithjustafewdishes': 1})
Should I rinse my dishes before putting them in?	You don't need to rinse them completely, but removing large food scraps can help.	Counter({'shouldirinsemydishesbeforeputtingthemin': 1})
How do I add rinse aid?	Find the rinse aid compartment, open it, and pour in the rinse aid until it's full without overflowing.	Counter({'howdoiaddrinseaid': 1})
Why do I need rinse aid?	Rinse aid helps dishes dry better and prevents water spots.	Counter({'whydoineedrinseaid': 1})
What is the Heat Dry option for?	The Heat Dry option helps to dry your dishes faster using heat.	Counter({'whatistheheatdryoptionfor': 1})
What if the spray arms are stuck?	Check for any dishes that might be blocking the spray arms from turning. Adjust them if needed.	Counter({'whatifthesprayarmsarestuck': 1})
How can I ensure my dishwasher smells fresh?	Regularly clean the filter and run a wash cycle with a cup of vinegar in a container placed on the top rack.	Counter({'howcaniensuremydishwashersmellsfresh': 1})
Can I use any detergent in the dishwasher?	It's best to use dishwasher detergent made specifically for dishwashers for the best results.	Counter({'caniuseanydetergentinthedishwasher': 1})
How do I prepare my dishes before loading them into the dishwasher?	Remove leftover food, bones, toothpicks, and any hard items from the dishes. Also, take off labels from containers.	Counter({'howdoipreparemydishesbeforeloadingthemintothedishwasher': 1})
What is important to check before I close the dishwasher door?	Make sure nothing is blocking the spray arm(s) so it can spin freely and that the detergent dispenser is not blocked.	Counter({'whatisimportanttocheckbeforeiclosethedishwasherdoor': 1})
How should I load my dishes into the dishwasher?	Load dishes with soiled surfaces facing down and inward toward the spray. Avoid overlapping items to ensure better cleaning.	Counter({'howshouldiloadmydishesintothedishwasher': 1})
Where should I place plastics, small plates, and glasses?	Place plastics, small plates, and glasses in the upper rack for best results.	Counter({'whereshouldiplaceplasticssmallplatesandglasses': 1})
Can I wash any type of dish in the dishwasher?	Only wash items that are marked 'dishwasher safe.'	Counter({'caniwashanytypeofdishinthedishwasher': 1})
What should I do to stop thumping noises while the dishwasher is running?	Load dishes so they do not touch one another and secure lightweight items in the racks.	Counter({'whatshouldidotostopthumpingnoiseswhilethedishwasherisrunning': 1})
How should I load silverware into the dishwasher?	Always place sharp items pointing down and avoid nesting. Mix silverware types to keep them separated.	Counter({'howshouldiloadsilverwareintothedishwasher': 1})
How do I add detergent to the dishwasher?	Add automatic dishwasher detergent just before starting a cycle. You can use powder, liquid, or tablet detergent.	Counter({'howdoiadddetergenttothedishwasher': 1})
What type of dishwasher detergent should I use?	Use only automatic dishwasher detergent. Tablet detergent is recommended for best results.	Counter({'whattypeofdishwasherdetergentshouldiuse': 1})
What factors affect how much detergent I should use?	The amount of detergent depends on how soiled the dishes are and the hardness of your water.	Counter({'whatfactorsaffecthowmuchdetergentishoulduse': 1})
How do I know if my water is hard or soft?	If your water has 0-6 grains per gallon, it’s hard. If it has 7-12 grains per gallon, it’s soft.	Counter({'howdoiknowifmywaterishardorsoft': 1})
How do I fill the detergent dispenser?	Fill the Main Wash section based on your water hardness. For heavily soiled items, fill the Pre-Wash section to the recommended level.	Counter({'howdoifillthedetergentdispenser': 1})
Do I need to use rinse aid in my dishwasher?	Yes, rinse aid helps with drying and prevents water spots on your dishes.	Counter({'doineedtouserinseaidinmydishwasher': 1})
How do I check the rinse aid level?	Look at the rinse aid indicator. Add rinse aid when it shows 'Add' level.	Counter({'howdoichecktherinseaidlevel': 1})
How do I add rinse aid to the dishwasher?	Turn the dispenser cap ¼ turn counterclockwise, lift it off, and pour rinse aid until the level is 'Full.' Replace and lock the cap.	Counter({'howdoiaddrinseaidtothedishwasher': 1})
What happens if I forget to add rinse aid?	Without rinse aid, your dishes may have spots or streaks, and the drying may not work well.	Counter({'whathappensififorgettoaddrinseaid': 1})
Can I run a rinse cycle without detergent?	Yes, if you do not plan to run a wash cycle soon, run a rinse cycle without detergent.	Counter({'canirunarinsecyclewithoutdetergent': 1})
What should I do if my dishes are still dirty after a cycle?	Check if you used enough detergent and if the dishes were loaded properly, with soiled sides facing down.	Counter({'whatshouldidoifmydishesarestilldirtyafteracycle': 1})
How can I prevent rust on my dishwasher?	Avoid washing metal items that can rust if they are not dishwasher safe. Regularly check and remove any rust if it appears.	Counter({'howcanipreventrustonmydishwasher': 1})
What do I do if the door won't close?	Make sure there are no dishes blocking the door and everything is loaded properly.	Counter({'whatdoidoifthedoorwontclose': 1})
Is it safe to wash glass dishes in the dishwasher?	You can wash glass dishes if they are marked 'dishwasher safe.' Use caution with very delicate glass.	Counter({'isitsafetowashglassdishesinthedishwasher': 1})
How do I check the water hardness level?	You can check the water hardness level using test strips available at home improvement stores. Follow the instructions on the package to see if you have hard water.	Counter({'howdoicheckthewaterhardnesslevel': 1})
Why do I see spots on my dishes after washing?	Spots on dishes are often caused by hard water. Adjust the rinse aid setting or the factory water hardness setting to help reduce spots.	Counter({'whydoiseespotsonmydishesafterwashing': 1})
How do I adjust the rinse aid setting?	Look for the arrow adjuster inside the rinse aid dispenser. Use your fingers or a flat-blade screwdriver to turn the adjuster until it points to the desired level.	Counter({'howdoiadjusttherinseaidsetting': 1})
What cleaning cycles can I choose from?	You can choose from different cycles like Sensor, Heavy, Normal, 1-Hr, Soak, and Clean. Pick one based on how dirty your dishes are.	Counter({'whatcleaningcyclescanichoosefrom': 1})
What options can I add to my cycle?	You can add options like Heat Dry, High Temp, Sani Rinse, and 4-Hr Delay. These options can change how well your dishes come out.	Counter({'whatoptionscaniaddtomycycle': 1})
How do I start the dishwasher?	To start, run hot water at the sink until it’s warm. Turn the water off, select your cycle and options, then press START/RESUME before you close the door.	Counter({'howdoistartthedishwasher': 1})
What temperature should the water be when it enters the dishwasher?	The water should be about 120°F (49°C) when it enters the dishwasher for the best cleaning results.	Counter({'whattemperatureshouldthewaterbewhenitentersthedishwasher': 1})
Can I open the door and add dishes while it's running?	You can add dishes at the beginning of the cycle. Open the door slowly, add the items, close the door firmly, and press START/RESUME.	Counter({'caniopenthedoorandadddisheswhileitsrunning': 1})
What should I do if I want to cancel the cycle?	To cancel a cycle, press the Cancel button. This will stop the washing process.	Counter({'whatshouldidoifiwanttocancelthecycle': 1})
How do I know if the dishwasher is done washing?	The dishwasher will stop running and make a sound or the lights will indicate that the cycle is complete. Check your model for specific signals.	Counter({'howdoiknowifthedishwasherisdonewashing': 1})
What if the dishwasher doesn't start?	If it doesn't start, check if the door is closed completely, ensure you have selected a cycle, and check for any error lights.	Counter({'whatifthedishwasherdoesntstart': 1})
Do I need to clean the filter in the dishwasher?	Yes, it’s a good idea to clean the filter regularly to keep the dishwasher running well. Refer to your manual for instructions on how to remove and clean it.	Counter({'doineedtocleanthefilterinthedishwasher': 1})
How often should I run the dishwasher?	You can run the dishwasher as often as you need. It's best to run it when it’s full for efficiency.	Counter({'howoftenshouldirunthedishwasher': 1})
What if my dishes still come out dirty?	If your dishes are still dirty, check the spray arms for clogs, ensure you’re using enough detergent, and check the water temperature.	Counter({'whatifmydishesstillcomeoutdirty': 1})
How much detergent should I use?	Use the amount recommended on the detergent packaging. It’s usually about one tablespoon for a normal wash.	Counter({'howmuchdetergentshouldiuse': 1})
Is it safe to wash all types of dishes?	Not all dishes are dishwasher safe. Avoid washing wooden items, certain plastics, and anything with metal that may rust.	Counter({'isitsafetowashalltypesofdishes': 1})
What can trigger a need for maintenance?	Signs can include bad smells, leftover food on dishes, leaks, or unusual noises when the dishwasher is running.	Counter({'whatcantriggeraneedformaintenance': 1})
How can I avoid bad smells in my dishwasher?	To prevent bad smells, clean the filter regularly and run a hot water cycle with vinegar or a dishwasher cleaner every month.	Counter({'howcaniavoidbadsmellsinmydishwasher': 1})
Can I wash pots and pans in the dishwasher?	Most pots and pans can be washed, but check the manufacturer's guidelines to see if they're dishwasher safe.	Counter({'caniwashpotsandpansinthedishwasher': 1})
What should I do if the door seems stuck?	If the door is stuck, check for any dishes or items blocking it. If not, ensure the latch is functioning properly.	Counter({'whatshouldidoifthedoorseemsstuck': 1})
How do I make my dishwasher quieter?	To reduce noise, make sure everything is loaded correctly and not touching each other. Regular maintenance can also help keep it quiet.	Counter({'howdoimakemydishwasherquieter': 1})
What does the Sani Rinse option do?	The Sani Rinse option heats the final rinse water to help kill bacteria and ensure your dishes are extra clean.	Counter({'whatdoesthesanirinseoptiondo': 1})
How do I start my dishwasher?	Load your dishes into the dishwasher, then select your desired wash cycle and press the start button to begin.	Counter({'howdoistartmydishwasher': 1})
Can I change the washing cycle after I start it?	You can change the washing cycle if you do it before the selected option begins. Just press a different cycle.	Counter({'canichangethewashingcycleafteristartit': 1})
What if I forgot to add detergent?	If you forgot to add detergent, stop the dishwasher, add it, and then restart the cycle.	Counter({'whatififorgottoadddetergent': 1})
How do I know which wash cycle to choose?	Choose a cycle based on how dirty your dishes are. Use 'Heavy' for very dirty dishes, 'Normal' for everyday use, and '1-Hour Wash' for quickly cleaning lightly soiled items.	Counter({'howdoiknowwhichwashcycletochoose': 1})
Why does my dishwasher make noises?	Some noises are normal as the dishwasher washes, pauses, and sprays water. This helps clean your dishes better.	Counter({'whydoesmydishwashermakenoises': 1})
What does the 'High Temp' option do?	'High Temp' raises the wash water temperature to help clean tough stains better.	Counter({'whatdoesthehightempoptiondo': 1})
How long does a normal wash cycle take?	A normal wash cycle takes about 2 hours and 32 minutes.	Counter({'howlongdoesanormalwashcycletake': 1})
Can I stop the dishwasher while it's running?	You can stop the dishwasher, but you should wait for it to pause completely before opening the door.	Counter({'canistopthedishwasherwhileitsrunning': 1})
What should I do if the door won't close?	Make sure there are no dishes blocking the door and that the latch is properly aligned. Try closing it again.	Counter({'whatshouldidoifthedoorwontclose': 1})
How do I know when a cycle is done?	The dishwasher will beep or light indicators will show when the wash cycle is complete.	Counter({'howdoiknowwhenacycleisdone': 1})
What is the 'Sani Rinse' option?	'Sani Rinse' raises the temperature of the final rinse water to kill more germs.	Counter({'whatisthesanirinseoption': 1})
Will the dishwasher adjust the wash time?	Yes, the dishwasher can adjust the wash time based on how dirty the dishes are and the incoming water temperature.	Counter({'willthedishwasheradjustthewashtime': 1})
How much water does the dishwasher use?	Water usage varies by cycle type. It can be between 2.4 to 7.4 gallons of water per cycle.	Counter({'howmuchwaterdoesthedishwasheruse': 1})
Can I wash plastic dishes in the dishwasher?	Yes, but make sure they are labeled as dishwasher safe to avoid damage.	Counter({'caniwashplasticdishesinthedishwasher': 1})
What is the best way to load dishes?	Load larger items on the bottom rack and smaller items on the top rack. Make sure nothing blocks the spray arms.	Counter({'whatisthebestwaytoloaddishes': 1})
How do I clean the dishwasher filter?	Remove the filter and rinse it under warm water. Scrub gently if needed and replace it after it dries.	Counter({'howdoicleanthedishwasherfilter': 1})
What should I do if my dishwasher smells bad?	Check for food debris in the filter and the bottom of the dishwasher. Clean it out to reduce odors.	Counter({'whatshouldidoifmydishwashersmellsbad': 1})
Can I use regular dish soap in the dishwasher?	No, use only dishwasher detergent made for dishwashers to prevent too many suds.	Counter({'caniuseregulardishsoapinthedishwasher': 1})
How often should I run the dishwasher?	Run the dishwasher whenever you have a full load of dirty dishes to save water and energy.	Counter({'howoftenshouldirunthedishwasher': 1})
What if there are spots on my glasses after washing?	Spots may happen if hard water is present. Consider using a rinse aid to help reduce spots.	Counter({'whatiftherearespotsonmyglassesafterwashing': 1})
Is it safe to leave the dishwasher running unattended?	Yes, it is generally safe, but make sure the dishwasher is not damaged or leaking before leaving.	Counter({'isitsafetoleavethedishwasherrunningunattended': 1})
How can I make my dishwasher last longer?	Regularly clean the filter, check for clogs, and use your dishwasher according to the manual to keep it in good shape.	Counter({'howcanimakemydishwasherlastlonger': 1})
How do I start the dishwasher?	Press the Start/Resume button to begin the wash cycle after selecting your desired options.	Counter({'howdoistartthedishwasher': 1})
What should I do if I opened the door during the wash cycle?	Close the door, then press the Start/Resume button again to continue the cycle.	Counter({'whatshouldidoifiopenedthedoorduringthewashcycle': 1})
How can I cancel a wash cycle?	Press the Cancel Drain button, then make sure the door is closed. The dishwasher will drain for 2 minutes to cancel the cycle.	Counter({'howcanicancelawashcycle': 1})
What does the Clean light mean?	The Clean light stays on when the wash cycle has finished successfully.	Counter({'whatdoesthecleanlightmean': 1})
How does the Heat Dry option work?	The Heat Dry option uses a heating element to help dry your dishes faster during the wash cycle.	Counter({'howdoestheheatdryoptionwork': 1})
Can I set a delay for starting the dishwasher?	Yes, press the 4-Hr Delay button to set a 4-hour delay before the wash cycle starts.	Counter({'canisetadelayforstartingthedishwasher': 1})
What happens if I don’t press Start/Resume after opening the door?	The cycle will not continue until you close the door and press the Start/Resume button.	Counter({'whathappensifidontpressstartresumeafteropeningthedoor': 1})
How do I activate the Control Lock feature?	Press and hold the 4-Hr Delay button for 3 seconds to activate the Control Lock and disable all buttons.	Counter({'howdoiactivatethecontrollockfeature': 1})
How do I turn off the Control Lock?	Press and hold the 4-Hr Delay button for 3 seconds again to turn off the Control Lock.	Counter({'howdoiturnoffthecontrollock': 1})
What if I need to add a dish during the wash cycle?	Open the door to add a dish, then close it. You will need to press the Start/Resume button to continue the cycle.	Counter({'whatifineedtoaddadishduringthewashcycle': 1})
How can I tell if my dishes are sanitized?	The Sanitized indicator light will glow when the dishes have been sanitized properly.	Counter({'howcanitellifmydishesaresanitized': 1})
What does the Cancel function do?	The Cancel function stops the current wash cycle and starts the draining process.	Counter({'whatdoesthecancelfunctiondo': 1})
Can I use Heat Dry with any wash cycle?	The Heat Dry option can be used with most cycles, except for the 1-Hour Wash.	Counter({'caniuseheatdrywithanywashcycle': 1})
What should I do if the dishwasher won't start?	Check if you have closed the door properly, and make sure to press the Start/Resume button after that.	Counter({'whatshouldidoifthedishwasherwontstart': 1})
How do I know if the wash cycle is still running?	The Start/Resume button LED will be lit when the cycle is in progress.	Counter({'howdoiknowifthewashcycleisstillrunning': 1})
Is there a certain amount of time for the Heat Dry option?	Heat Dry can add between 8 to 46 minutes to the wash cycle, depending on the cycle selected.	Counter({'isthereacertainamountoftimefortheheatdryoption': 1})
What if the Control Lock is activated and I need to use the dishwasher?	You will need to hold the 4-Hr Delay button for 3 seconds to deactivate the Control Lock.	Counter({'whatifthecontrollockisactivatedandineedtousethedishwasher': 1})
How do I reset the delay time?	Press the Delay button until the desired delay time is displayed to reset it.	Counter({'howdoiresetthedelaytime': 1})
Can I delay the wash cycle for less than 4 hours?	You cannot set a delay shorter than 4 hours with the 4-Hr Delay option.	Counter({'canidelaythewashcycleforlessthan4hours': 1})
What do I do if the Clean indicator doesn't turn on after a cycle?	Check to make sure the cycle was completed, and the door was closed properly during the wash.	Counter({'whatdoidoifthecleanindicatordoesntturnonafteracycle': 1})
What if my dishes are still dirty after a wash?	Make sure to load the dishwasher properly and use the appropriate wash cycle for your load.	Counter({'whatifmydishesarestilldirtyafterawash': 1})
How should I care for the inside of the dishwasher?	Regularly wipe down the interior with a damp cloth and avoid using harsh chemicals.	Counter({'howshouldicarefortheinsideofthedishwasher': 1})
How can I clean the filter in the dishwasher?	Check your manual for the location of the filter, then remove it and rinse it under running water to clean.	Counter({'howcanicleanthefilterinthedishwasher': 1})
How do I set up my dishwasher?	Place your dishwasher on a flat, even surface near a water supply. Connect the water hose and plug in the power cord. Make sure the dishwasher is leveled.	Counter({'howdoisetupmydishwasher': 1})
How do I load the silverware basket?	You can load the silverware basket by placing forks, knives, and spoons inside it. Ensure the front panel is locked before using the bottom rack.	Counter({'howdoiloadthesilverwarebasket': 1})
How do I unlock the silverware basket?	To unlock, grasp the front panel, pull it up, and turn it 90 degrees. Make sure it’s fully in place before pulling the bottom rack out.	Counter({'howdoiunlockthesilverwarebasket': 1})
How can I remove the silverware basket from the door?	To remove it, grasp the basket by the handle, slide it toward the top of the door, and lift it off the holding buttons.	Counter({'howcaniremovethesilverwarebasketfromthedoor': 1})
How do I put the silverware basket back in the door?	Set the silverware basket on the holding buttons and slide it toward the bottom of the door until it clicks into place.	Counter({'howdoiputthesilverwarebasketbackinthedoor': 1})
What are the cup shelves for?	Cup shelves can hold extra cups, stemware, or long items like spatulas. You can fold them down to create more space in the top rack.	Counter({'whatarethecupshelvesfor': 1})
How do I adjust the fold-down tines?	To adjust the tines, grasp the tip of the tine and push it out of the holder. Then, lay the tines down toward the center of the rack.	Counter({'howdoiadjustthefolddowntines': 1})
What are light item clips used for?	Light item clips hold lightweight plastic items in place, like cups and bowls, during washing to prevent them from moving around.	Counter({'whatarelightitemclipsusedfor': 1})
How do I move a light item clip?	To move a clip, pull it up off the tine and reposition it on another tine where you need it.	Counter({'howdoimovealightitemclip': 1})
What are EZ Adjust Tines?	EZ Adjust Tines are sliding tines on the lower rack that can move left or right. They help fit larger dishes, like cereal bowls.	Counter({'whatareezadjusttines': 1})
How does the silverware spray work?	The silverware spray provides a strong shower of water to the in-door basket, helping to clean stuck-on food without needing to rewash.	Counter({'howdoesthesilverwarespraywork': 1})
How do I turn on the dishwasher?	To turn on the dishwasher, close the door securely. Then, select your wash cycle and press the start button.	Counter({'howdoiturnonthedishwasher': 1})
Should I rinse my dishes before putting them in the dishwasher?	Rinsing is not necessary but scraping off large food particles helps ensure better washing.	Counter({'shouldirinsemydishesbeforeputtingtheminthedishwasher': 1})
What's the best way to load the bottom rack?	Load larger items like pots and pans in the bottom rack. Place them facing down for the best cleaning.	Counter({'whatsthebestwaytoloadthebottomrack': 1})
Can I wash plastic dishes in the dishwasher?	Yes, you can wash plastic dishes, but place them on the top rack to avoid melting.	Counter({'caniwashplasticdishesinthedishwasher': 1})
How do I clean the filters in the dishwasher?	Remove the bottom rack, locate the filters, and rinse them under running water to remove any debris.	Counter({'howdoicleanthefiltersinthedishwasher': 1})
What should I do if my dishwasher is not starting?	Check if the door is completely closed and latched. Ensure it is plugged in and there’s power to the outlet.	Counter({'whatshouldidoifmydishwasherisnotstarting': 1})
How do I know when my dishwasher cycle is done?	Most dishwashers have a light or an indicator that will turn off when the cycle is complete. Listen for a sound if your model has one.	Counter({'howdoiknowwhenmydishwashercycleisdone': 1})
Can I use regular dish soap in my dishwasher?	No, use only dishwasher detergent. Regular dish soap can create too many bubbles and cause a mess.	Counter({'caniuseregulardishsoapinmydishwasher': 1})
How often should I clean my dishwasher?	Clean the interior and filters monthly. This helps it run more efficiently and extends its life.	Counter({'howoftenshouldicleanmydishwasher': 1})
What if my dishes are coming out dirty?	Make sure you’re loading them correctly, not overcrowding, and that you’re using enough detergent.	Counter({'whatifmydishesarecomingoutdirty': 1})
Is it safe to run the dishwasher when I'm not home?	Yes, it is safe to run the dishwasher when you’re away, but always ensure it's connected properly.	Counter({'isitsafetorunthedishwasherwhenimnothome': 1})
How do I raise the top rack?	Hold the top rack with one hand near the adjuster. With your other hand, pull out the top of the adjuster and raise it to one of the preset positions.	Counter({'howdoiraisethetoprack': 1})
How do I lower the top rack?	Lift up on the top rack and then let it down to lower it.	Counter({'howdoilowerthetoprack': 1})
Can I fit tall items in the dishwasher?	You can fit tall items by raising the top rack to a higher position.	Counter({'canifittallitemsinthedishwasher': 1})
What if the top rack is not level?	Make sure to adjust the rack so it is level for proper use.	Counter({'whatifthetoprackisnotlevel': 1})
How do I remove the top rack?	Pull the upper rack forward about halfway. Open the track stops by flipping them toward the outside, then pull the top rack out of the rails.	Counter({'howdoiremovethetoprack': 1})
What should I do before removing the top rack?	Remove any dishes from the top rack before you take it out of the dishwasher.	Counter({'whatshouldidobeforeremovingthetoprack': 1})
How can I wash larger items?	You can wash larger items by removing the top rack and using the bottom rack.	Counter({'howcaniwashlargeritems': 1})
How do I replace the top rack after removing it?	Gently pull the tracks forward, open the track stops, place the back wheels of the rack into the track slot, and then slide the rack back into the tracks.	Counter({'howdoireplacethetoprackafterremovingit': 1})
What happens if I push the top rack all the way in while replacing it?	Don’t push the rack all the way in yet; just secure the back wheels first and then insert the front wheels.	Counter({'whathappensifipushthetoprackallthewayinwhilereplacingit': 1})
How do I make sure the track stops close after putting the top rack in?	The track stops will automatically close when you push the rack into the dishwasher.	Counter({'howdoimakesurethetrackstopscloseafterputtingthetoprackin': 1})
Is it okay to wash cookie sheets in the dishwasher?	You can wash cookie sheets by removing the top rack first.	Counter({'isitokaytowashcookiesheetsinthedishwasher': 1})
What kind of items can I wash in the top rack?	You can wash smaller items like cups and bowls in the top rack.	Counter({'whatkindofitemscaniwashinthetoprack': 1})
How do I know if the top rack is safe to adjust?	Make sure the top rack is empty and the dishes are removed before adjusting it.	Counter({'howdoiknowifthetoprackissafetoadjust': 1})
What should I do if I can't lift the top rack?	Check if the adjuster mechanism is stuck or blocked by dishes. Make sure the rack is not overloaded.	Counter({'whatshouldidoificantliftthetoprack': 1})
Can I wash pots in the dishwasher?	Pots are best washed in the bottom rack when you remove the top rack.	Counter({'caniwashpotsinthedishwasher': 1})
How do I keep the top rack in place after adjusting?	Once you adjust the top rack, it should stay in place. Ensure it is pushed in securely after usage.	Counter({'howdoikeepthetoprackinplaceafteradjusting': 1})
What do I do if the top rack won’t adjust?	Ensure there's nothing blocking the adjusters. If it’s still stuck, check the manual for troubleshooting steps.	Counter({'whatdoidoifthetoprackwontadjust': 1})
Can I wash large items if the top rack is still in place?	No, larger items should be washed in the bottom rack after removing the top rack.	Counter({'caniwashlargeitemsifthetoprackisstillinplace': 1})
How can I clean the dishwasher itself?	Remove any leftover food particles and wipe the interior with a damp cloth.	Counter({'howcanicleanthedishwasheritself': 1})
Is it safe to put fragile items on the top rack?	Yes, the top rack is designed for lighter and more fragile items.	Counter({'isitsafetoputfragileitemsonthetoprack': 1})
What if dishes are still dirty after a wash cycle?	Check the spray arms to ensure they can move freely and are not blocked.	Counter({'whatifdishesarestilldirtyafterawashcycle': 1})
How should I load the bottom rack?	Place larger items like pots and pans in the bottom rack for a thorough clean.	Counter({'howshouldiloadthebottomrack': 1})
How do I clean the dishwasher filters?	To clean the filters, first turn the Upper Filter Assembly ¼ turn counterclockwise and lift it out. Then, separate the Upper Filter Assembly by gently pulling it apart. Rinse the filters under running water until most soils are removed.	Counter({'howdoicleanthedishwasherfilters': 1})
When should I clean the filters?	Clean the filters when you see visible dirt or if your dishes feel gritty. If cleaning performance drops and soils remain on dishes, it's time to clean the filters.	Counter({'whenshouldicleanthefilters': 1})
How often should I clean the filters?	The cleaning frequency depends on how many loads you do. If you do 8-12 loads a week and only scrape before loading, clean every two months. If you do just 1-3 loads a week, clean twice a year.	Counter({'howoftenshouldicleanthefilters': 1})
What if I have very hard water?	If your water is very hard (above 15 grains), clean your filter at least once a month. Look out for white residue inside the dishwasher as it may indicate hard water.	Counter({'whatifihaveveryhardwater': 1})
What do I do if the dishwasher isn't cleaning well?	If your dishwasher isn't cleaning well, check the filters. They may need to be cleaned if you see dirt or if your dishes are still dirty after a wash.	Counter({'whatdoidoifthedishwasherisntcleaningwell': 1})
What tools do I need to clean the filters?	You only need running water to rinse the filters. If there are hard-to-remove soils, a soft brush might be needed, but do not use wire brushes or scouring pads.	Counter({'whattoolsdoineedtocleanthefilters': 1})
Can I wash the filters in the dishwasher?	It is best to rinse the filters under running water. Washing them in the dishwasher may not clean them properly.	Counter({'caniwashthefiltersinthedishwasher': 1})
What happens if I don’t clean the filters?	Not cleaning the filters can lead to poor cleaning performance and dirty dishes. It can also cause foreign objects to enter the pump.	Counter({'whathappensifidontcleanthefilters': 1})
How do I know if I need to clean the lower filter?	You should clean the lower filter if you notice dirt or food particles on your dishes or if cleaning performance decreases.	Counter({'howdoiknowifineedtocleanthelowerfilter': 1})
Is it hard to remove the filters?	No, it's easy to remove and maintain the filters. Just follow the instructions for turning and lifting them out.	Counter({'isithardtoremovethefilters': 1})
How do I check for hard water buildup?	Look for white residue inside your dishwasher. This indicates hard water, and you may need to clean the filters more often.	Counter({'howdoicheckforhardwaterbuildup': 1})
Can I use soap to clean the filters?	It's better to just rinse the filters under running water without soap. Soap can leave a residue that might affect cleaning.	Counter({'caniusesoaptocleanthefilters': 1})
What type of brush should I use for tough spots?	Use a soft brush to remove any tough soils or calcium deposits. Avoid any hard brushes that can scratch the filters.	Counter({'whattypeofbrushshouldiusefortoughspots': 1})
How can I improve my dishwasher's cleaning power?	To improve cleaning power, make sure to clean the filters regularly and scrape off food before loading dishes. This helps the dishwasher work better.	Counter({'howcaniimprovemydishwasherscleaningpower': 1})
Is it okay to run the dishwasher if the filters are dirty?	Running the dishwasher with dirty filters can lead to poor cleaning results and may damage the appliance. Always clean them for best results.	Counter({'isitokaytorunthedishwasherifthefiltersaredirty': 1})
How do I assemble the Upper Filter Assembly after cleaning?	After cleaning, just align the Upper Filter Assembly and gently push it back together before placing it back in the dishwasher.	Counter({'howdoiassembletheupperfilterassemblyaftercleaning': 1})
Can I use a scouring pad to clean the filters?	No, do not use scouring pads or wire brushes. These can damage the filters and reduce their effectiveness.	Counter({'caniuseascouringpadtocleanthefilters': 1})
What if my dishes still have spots after washing?	If your dishes are spotting after washing, check your filters for clogs. It may also be a sign of hard water, which requires more frequent filter cleaning.	Counter({'whatifmydishesstillhavespotsafterwashing': 1})
How do I store the filters if I remove them for cleaning?	Store the filters in a clean, dry place until you are ready to reassemble them. Avoid leaving them exposed to dust or moisture.	Counter({'howdoistorethefiltersifiremovethemforcleaning': 1})
What should I do if food is stuck on the filters?	If food is stuck, rinse the filters longer under running water and use a soft brush to gently scrub the stuck areas.	Counter({'whatshouldidoiffoodisstuckonthefilters': 1})
Do I need any special products for filter cleaning?	No special products are needed. Simply rinsing under water is usually enough to clean the filters effectively.	Counter({'doineedanyspecialproductsforfiltercleaning': 1})
How do I put the filters back in my dishwasher?	Place the Lower Filter under the tabs at the bottom of the dishwasher. Then, insert the Upper Filter Assembly into the Lower Filter and turn it clockwise until it locks in place.	Counter({'howdoiputthefiltersbackinmydishwasher': 1})
What should I do if the Upper Filter does not seem locked in?	If the Upper Filter spins freely, keep turning it clockwise until it drops and locks into place. Make sure it’s secured before running the dishwasher.	Counter({'whatshouldidoiftheupperfilterdoesnotseemlockedin': 1})
How do I clean the outside of my dishwasher?	Use a soft, damp cloth with mild detergent to clean the exterior. For stainless steel surfaces, use a recommended stainless steel cleaner.	Counter({'howdoicleantheoutsideofmydishwasher': 1})
What is the best way to clean the inside of my dishwasher?	Clean the inside with a paste of powdered dishwasher detergent and water. You can also use liquid detergent on a damp sponge.	Counter({'whatisthebestwaytocleantheinsideofmydishwasher': 1})
How can I remove stains or white spots inside my dishwasher?	Pour 2 cups of white vinegar into a glass on the bottom rack. Run a complete wash cycle without detergent. This can help remove spots.	Counter({'howcaniremovestainsorwhitespotsinsidemydishwasher': 1})
Is it safe to use vinegar in my dishwasher often?	Vinegar can help with stains, but using it too often could damage your dishwasher. Use it occasionally instead of every wash.	Counter({'isitsafetousevinegarinmydishwasheroften': 1})
What is the maintenance procedure for hard water stains?	Use a monthly maintenance cleaner like affresh® Dishwasher Cleaner. Load your dishwasher with soiled dishes, place the tablet in the detergent dispenser, and select an appropriate wash cycle.	Counter({'whatisthemaintenanceprocedureforhardwaterstains': 1})
Should I use regular detergent for maintenance cleaning?	For maintenance cleaning with products like affresh®, use the cleaning tablet instead of regular detergent.	Counter({'shouldiuseregulardetergentformaintenancecleaning': 1})
How can I tell if my dishwasher isn’t draining well?	If you notice water left at the bottom or if your dishes are wet after a wash, it may not be draining well. Check the drain air gap if you have one.	Counter({'howcanitellifmydishwasherisntdrainingwell': 1})
What should I do in summer if I won’t use my dishwasher?	Turn off the water and power supply to the dishwasher when you’re not using it for a long time during summer.	Counter({'whatshouldidoinsummerifiwontusemydishwasher': 1})
How do I protect my dishwasher from freezing in winter?	Make sure the water supply lines are protected against freezing temperatures. Ice can damage your dishwasher and home.	Counter({'howdoiprotectmydishwasherfromfreezinginwinter': 1})
What do I need to do before storing my dishwasher for the winter?	Before winter storage, consider having your dishwasher winterized by authorized service personnel to avoid water damage.	Counter({'whatdoineedtodobeforestoringmydishwasherforthewinter': 1})
Can I run my dishwasher if the filters aren’t in place?	Do not use your dishwasher without the filters properly installed, or it may get damaged.	Counter({'canirunmydishwasherifthefiltersarentinplace': 1})
How should I clean my dishwasher if it smells bad?	A vinegar rinse can help remove odors. Just follow the instructions for cleaning the interior with vinegar.	Counter({'howshouldicleanmydishwasherifitsmellsbad': 1})
What is the best way to clean tough stains in my dishwasher?	Using a dishwasher cleaning product like affresh® can help remove tough stains. Follow the product directions for best results.	Counter({'whatisthebestwaytocleantoughstainsinmydishwasher': 1})
How do I know I am using the right amount of detergent?	For regular use, it's best to use a premeasured detergent tablet or pack. This helps ensure you use the right amount.	Counter({'howdoiknowiamusingtherightamountofdetergent': 1})
What if my dishes are still dirty after a wash?	Make sure the filters are clean and properly installed. Also, check that you are using enough detergent and loading the dishes correctly.	Counter({'whatifmydishesarestilldirtyafterawash': 1})
Is there anything I shouldn’t clean my dishwasher with?	Avoid using harsh chemicals or abrasive cleaners that could scratch or damage the interior and exterior of your dishwasher.	Counter({'isthereanythingishouldntcleanmydishwasherwith': 1})
How often should I clean my dishwasher?	It's a good idea to clean your dishwasher's filters regularly and do a thorough cleaning with vinegar or a dishwasher cleaner at least once a month.	Counter({'howoftenshouldicleanmydishwasher': 1})
Can I leave water in the dishwasher?	It's best to not leave standing water in your dishwasher. If you notice water after a cycle, check for drainage issues.	Counter({'canileavewaterinthedishwasher': 1})
Why isn't my dishwasher running?	Check if the door is closed tightly and latched. Make sure the right cycle is selected and that there is power to the dishwasher.	Counter({'whyisntmydishwasherrunning': 1})
What should I do if the clean light is flashing?	Look for the overfill protection float. It should move freely. Also, make sure the water supply is turned on and check for suds in the dishwasher.	Counter({'whatshouldidoifthecleanlightisflashing': 1})
How can I fix my dishwasher if it won't fill?	Press down on the overfill protection float to make sure it can move up and down freely.	Counter({'howcanifixmydishwasherifitwontfill': 1})
Why does my dishwasher run for a long time?	Try using the 1 Hour Wash cycle. Check if the water is hot enough and that the cycle time is normal for the selected wash.	Counter({'whydoesmydishwasherrunforalongtime': 1})
What should I check if there's water left in the dishwasher?	Make sure the cycle is complete and that the disposer knockout plug was removed during installation.	Counter({'whatshouldicheckifthereswaterleftinthedishwasher': 1})
Why is there detergent left in the dispenser?	Check if the cycle is complete. Look for items blocking the dispenser and make sure the detergent is not clumpy.	Counter({'whyistheredetergentleftinthedispenser': 1})
How do I remove white residue from the dishwasher?	Check if you used too much detergent or if the brand you are using creates excess foam. Try a different detergent if needed.	Counter({'howdoiremovewhiteresiduefromthedishwasher': 1})
What should I do if my dishwasher smells bad?	Clean the filters regularly and try running a vinegar rinse. You can also use a dishwasher cleaner once a month.	Counter({'whatshouldidoifmydishwashersmellsbad': 1})
Why is there condensation on my kitchen counter?	Check if the dishwasher is aligned with the countertop. Moisture from the dishwasher vent can cause this issue.	Counter({'whyistherecondensationonmykitchencounter': 1})
What can cause my dishwasher to pause during a wash?	It's normal for certain cycles to pause briefly. Make sure everything else is working properly if it pauses for too long.	Counter({'whatcancausemydishwashertopauseduringawash': 1})
How can I tell if the dishwasher is getting power?	Check if household fuses are blown or the circuit breaker has tripped. Replace the fuse or reset the breaker if needed.	Counter({'howcanitellifthedishwasherisgettingpower': 1})
What do I do if the motor stops in my dishwasher?	The motor will reset itself after a few minutes. If it does not restart, you may need to call for service.	Counter({'whatdoidoifthemotorstopsinmydishwasher': 1})
Is the overfill protection float important?	Yes, it helps the dishwasher fill with the correct amount of water. Make sure it can move freely.	Counter({'istheoverfillprotectionfloatimportant': 1})
What happens if I use the wrong detergent?	Using the wrong detergent can cause suds which may prevent the dishwasher from running properly. Always use the recommended dishwasher detergent.	Counter({'whathappensifiusethewrongdetergent': 1})
How do I clean the filters in my dishwasher?	Refer to the manual for the recommended time interval. Clean them regularly to keep the dishwasher running well.	Counter({'howdoicleanthefiltersinmydishwasher': 1})
Can I use a vinegar rinse in my dishwasher?	Yes, running a vinegar rinse can help eliminate odors. Follow the instructions in the manual for the best results.	Counter({'caniuseavinegarrinseinmydishwasher': 1})
What should I check after installing my dishwasher?	Make sure the water supply is turned on and that all connections are secure. Also, remove the disposer knockout plug if you haven’t already.	Counter({'whatshouldicheckafterinstallingmydishwasher': 1})
How do I prevent odor buildup in my dishwasher?	Run the dishwasher regularly, clean the filters, and use a dishwasher cleaner tablet monthly.	Counter({'howdoipreventodorbuildupinmydishwasher': 1})
Why is it important to replace the rinse aid dispenser cap?	Not replacing the rinse aid cap after filling can cause suds, which may prevent the dishwasher from working correctly.	Counter({'whyisitimportanttoreplacetherinseaiddispensercap': 1})
What's the best way to choose a wash cycle?	Select the cycle based on how dirty your dishes are. The manual has details on which cycle is best for different types of loads.	Counter({'whatsthebestwaytochooseawashcycle': 1})
Why does the bottom rack not fully slide into the dishwasher?	Check to see if items are blocking the spray jets or spray arm. Remove or reload the items to keep them from interfering.	Counter({'whydoesthebottomracknotfullyslideintothedishwasher': 1})
What can I do if my dishes do not dry completely?	Make sure you are using a rinse aid. It helps reduce moisture and improves drying. Also, use the heated drying option for better results.	Counter({'whatcanidoifmydishesdonotdrycompletely': 1})
Why are my plastics still wet after a wash?	Plastics often do not dry well in the dishwasher. You may need to towel dry them after the cycle is finished.	Counter({'whyaremyplasticsstillwetafterawash': 1})
How can I tell if I need more rinse aid?	Check the rinse aid indicator on the dishwasher. If it is empty or low, refill it for better drying performance.	Counter({'howcanitellifineedmorerinseaid': 1})
What causes spots and stains on my dishes?	Hard water or high mineral content in your water can cause spots. Using a rinse aid during the final rinse helps reduce this issue.	Counter({'whatcausesspotsandstainsonmydishes': 1})
What temperature should my water be for best cleaning?	The water temperature entering the dishwasher should be about 120°F (49°C) for the best cleaning results.	Counter({'whattemperatureshouldmywaterbeforbestcleaning': 1})
How much detergent should I use in the dishwasher?	Use at least 1 tablespoon (15 grams) of detergent per load. Make sure the detergent is fresh for it to work effectively.	Counter({'howmuchdetergentshouldiuseinthedishwasher': 1})
Is there a better type of detergent to use?	Dishwasher detergent tablets and packs are recommended as they are more effective than powder, liquid, or gel detergents.	Counter({'isthereabettertypeofdetergenttouse': 1})
What should I do if my glassware has spots?	Remove all metal items and run a vinegar rinse to help clean the glassware and reduce spots.	Counter({'whatshouldidoifmyglasswarehasspots': 1})
What is silica film on my dishes?	Silica film looks like a milky, rainbow color on glassware and is caused by the water and detergent. Using less detergent and a rinse aid can help.	Counter({'whatissilicafilmonmydishes': 1})
Why are my nonstick pans getting white spots?	The dishwasher detergent can remove the seasoning from nonstick cookware. Reseason the cookware after washing.	Counter({'whyaremynonstickpansgettingwhitespots': 1})
What can I do about brown stains on my dishes?	High iron content in your water can cause brown stains. Rinse the dishes with citric acid crystals and run a normal wash cycle.	Counter({'whatcanidoaboutbrownstainsonmydishes': 1})
How do I remove black or gray marks from my dishes?	These marks may come from aluminum items. Handwash disposable aluminum items to prevent marking, and use a mild abrasive cleaner to remove any marks.	Counter({'howdoiremoveblackorgraymarksfrommydishes': 1})
How can I fix orange stains on my plastic dishes?	Orange stains may come from tomato-based foods. Use a stain removal product to help clean them, but they won't affect how the dishwasher works.	Counter({'howcanifixorangestainsonmyplasticdishes': 1})
Why does my dishwasher make grinding sounds?	Grinding sounds may mean a hard object is stuck in the wash module. The noise should stop once the object is ground up. If it continues, you may need to call for service.	Counter({'whydoesmydishwashermakegrindingsounds': 1})
What does it mean when the dishwasher stops and starts frequently?	It is normal for the dishwasher to stop and start during the cycle. This helps with cleaning performance and saves energy.	Counter({'whatdoesitmeanwhenthedishwasherstopsandstartsfrequently': 1})
Why do I hear a hissing sound from the dishwasher?	A hissing sound is normal. It usually happens when the water valve fills the dishwasher.	Counter({'whydoihearahissingsoundfromthedishwasher': 1})
What should I do if my dishwasher is making a lot of noise?	Noises like snapping are normal when the detergent dispenser opens. If you hear unusual grinding or buzzing that doesn't stop, check for any objects inside.	Counter({'whatshouldidoifmydishwasherismakingalotofnoise': 1})
What should I check if my dishes are still dirty after a wash cycle?	Make sure not to overload the dishwasher. Allow enough space for water to reach all dishes. Use a proper amount of detergent too.	Counter({'whatshouldicheckifmydishesarestilldirtyafterawashcycle': 1})
Can I put aluminum items in the dishwasher?	It's best not to put disposable aluminum items in the dishwasher as they can break down and leave marks on other dishes.	Counter({'caniputaluminumitemsinthedishwasher': 1})
How can I solve the problem of filming on my dishes?	Use a rinse aid to help reduce filming. Also, ensure your water temperature is high enough and consider the quality of your detergent.	Counter({'howcanisolvetheproblemoffilmingonmydishes': 1})
Why are my dishes not completely clean after a wash?	Check if your dishwasher is loaded correctly first. If it's not, it can block water from reaching all the dishes.	Counter({'whyaremydishesnotcompletelycleanafterawash': 1})
What should I do if there's food left on my dishes?	Make sure to clean the filters regularly. Check your manual for how often to do this.	Counter({'whatshouldidoiftheresfoodleftonmydishes': 1})
Did I choose the right wash cycle?	If your dishes are heavily soiled, select a heavier wash cycle to get them clean.	Counter({'didichoosetherightwashcycle': 1})
What temperature should the water be when it enters the dishwasher?	The best water temperature for cleaning is 120°F (49°C). Make sure your water is this hot before starting.	Counter({'whattemperatureshouldthewaterbewhenitentersthedishwasher': 1})
How much detergent should I use?	Use at least 1 tablespoon (15 grams) of fresh, recommended dishwasher detergent for each load.	Counter({'howmuchdetergentshouldiuse': 1})
What if there’s caked detergent in the dispenser?	Clean the dispenser if you see caked detergent. Always use fresh detergent and avoid letting it sit in a wet dispenser.	Counter({'whatiftherescakeddetergentinthedispenser': 1})
Can labels from bottles clog the dishwasher?	Yes, if labels get stuck in the pump or spray arm, they can block water flow. Check and remove any labels.	Counter({'canlabelsfrombottlesclogthedishwasher': 1})
What water pressure do I need for my dishwasher?	Your home water pressure should be between 20 to 120 psi (138 to 828 kPa) for the dishwasher to fill properly.	Counter({'whatwaterpressuredoineedformydishwasher': 1})
Is it okay to use laundry detergent in my dishwasher?	No, you should only use recommended dishwasher detergents. Avoid using laundry soaps.	Counter({'isitokaytouselaundrydetergentinmydishwasher': 1})
How do I prevent my dishes from chipping?	Load the dishes so they are stable and won’t hit each other during washing. Pull the racks in and out gently.	Counter({'howdoipreventmydishesfromchipping': 1})
Should I wash delicate dishes in the dishwasher?	Antiques and delicate glassware may not be safe in the dishwasher. It's better to wash these items by hand.	Counter({'shouldiwashdelicatedishesinthedishwasher': 1})
What should I do if the dishwasher is making strange noises?	Check if there are any items stuck in the spray arms or if anything is blocking the pump.	Counter({'whatshouldidoifthedishwasherismakingstrangenoises': 1})
How can I keep my dishwasher clean?	Regularly clean the filters and wipe down the inside with a damp cloth to remove food residue.	Counter({'howcanikeepmydishwasherclean': 1})
How often should I clean the filters?	Refer to the manual for the recommended cleaning schedule for your dishwasher’s filters.	Counter({'howoftenshouldicleanthefilters': 1})
What happens if I don’t use enough detergent?	Not using enough detergent can result in dirty dishes. Always measure out at least 1 tablespoon.	Counter({'whathappensifidontuseenoughdetergent': 1})
Why are there spots on my clean dishes?	Spots can be caused by hard water. You might need to use a rinse aid to help with this.	Counter({'whyaretherespotsonmycleandishes': 1})
Is it safe to run the dishwasher at night?	Yes, it's safe to run the dishwasher at night as long as you follow all safety precautions.	Counter({'isitsafetorunthedishwasheratnight': 1})
Can I overload the dishwasher?	Avoid overloading, as it can block water and reduce cleaning effectiveness.	Counter({'canioverloadthedishwasher': 1})
What is the best way to load glasses?	Place glasses upside down on the top rack to prevent them from filling with water.	Counter({'whatisthebestwaytoloadglasses': 1})
How can I remove stuck-on food from dishes before loading?	Rinse off stuck-on food before loading. This helps the dishwasher clean better.	Counter({'howcaniremovestuckonfoodfromdishesbeforeloading': 1})
What should I do if my dishwasher leaks?	Turn it off and check for loose hoses or cracks in the door seal. You may need to call for help.	Counter({'whatshouldidoifmydishwasherleaks': 1})
How do I start my dishwasher?	To start your dishwasher, first load it with the dishes, ensuring they are facing the spray arms. Close the door and turn the dial or press the button for the wash cycle you want. Then, press the start button.	Counter({'howdoistartmydishwasher': 1})
What should I do if the dishwasher doesn't start?	Check to make sure the door is fully closed, as the dishwasher won't start if the door is open. Also, ensure it's plugged in and that the circuit breaker hasn't tripped.	Counter({'whatshouldidoifthedishwasherdoesntstart': 1})
How do I load dishes properly?	Place larger items like pots and pans on the bottom rack and smaller items like cups and glasses on the top rack. Make sure items don’t block the spray arms.	Counter({'howdoiloaddishesproperly': 1})
Can I wash plastic items in the dishwasher?	Yes, but make sure they are labeled as dishwasher safe. Place them on the top rack to avoid melting.	Counter({'caniwashplasticitemsinthedishwasher': 1})
Why are my dishes still dirty after washing?	This could happen if the dishwasher is overloaded, if the spray arms are clogged, or if you're using low-quality detergent. Make sure to load it properly and check the spray arms.	Counter({'whyaremydishesstilldirtyafterwashing': 1})
How often should I clean the dishwasher?	It's a good idea to clean the dishwasher every month. You can do this by checking for food debris and running an empty cycle with vinegar.	Counter({'howoftenshouldicleanthedishwasher': 1})
What kind of detergent should I use?	Look for a dishwasher detergent that is specifically made for dishwashers. Follow the instructions for how much to use on the package.	Counter({'whatkindofdetergentshouldiuse': 1})
How do I know if my dishwasher needs service?	If you notice leaks, strange noises, or if it stops working, it may need service. Also, if it consistently leaves dishes dirty, check the troubleshooting section.	Counter({'howdoiknowifmydishwasherneedsservice': 1})
What should I avoid putting in the dishwasher?	Avoid washing wooden items, non-dishwasher safe plastics, cast iron, and anything that has a non-stick coating that isn't labeled safe for the dishwasher.	Counter({'whatshouldiavoidputtinginthedishwasher': 1})
How can I fix a dishwasher that leaks?	First, check the door seal for any damage. Also, ensure the water inlet valve is working properly and that hoses are securely attached.	Counter({'howcanifixadishwasherthatleaks': 1})
What do I do if I smell something bad in the dishwasher?	Check for food debris stuck in the bottom or filter. Running a cycle with vinegar can help remove odors.	Counter({'whatdoidoifismellsomethingbadinthedishwasher': 1})
How do I clean the filter in my dishwasher?	Locate the filter at the bottom of the dishwasher, take it out, and rinse it under warm water to remove any debris. Let it dry before putting it back.	Counter({'howdoicleanthefilterinmydishwasher': 1})
Can I use regular dish soap in my dishwasher?	No, regular dish soap can cause too many bubbles and may damage the machine. Use only dishwasher-specific detergent.	Counter({'caniuseregulardishsoapinmydishwasher': 1})
What should I check if my dishwasher is making loud noises?	Check for loose items in the dishwasher that may be knocking around. Also, verify that the spray arms can spin freely without obstruction.	Counter({'whatshouldicheckifmydishwasherismakingloudnoises': 1})
How do I reset my dishwasher?	To reset your dishwasher, unplug it for a minute or turn off the circuit breaker. Then plug it back in or switch the breaker on.	Counter({'howdoiresetmydishwasher': 1})
Why is my dishwasher not draining?	Check for clogs in the drain hose or the filter. If those are clear and it still won't drain, it may need service.	Counter({'whyismydishwashernotdraining': 1})
How can I make my dishes dry better?	Try using a rinse aid, which helps water slide off dishes. You can also use a heated dry cycle if your dishwasher has one.	Counter({'howcanimakemydishesdrybetter': 1})
What is covered under the warranty for my dishwasher?	The warranty covers factory specified parts and repair labor for defects in materials or workmanship within one year of purchase.	Counter({'whatiscoveredunderthewarrantyformydishwasher': 1})
What is not covered under the warranty?	Damage from misuse, improper maintenance, and the use of non-genuine parts are not covered. Also, food loss due to machine failure won't be covered.	Counter({'whatisnotcoveredunderthewarranty': 1})
How do I get service for my dishwasher?	Call the Customer Experience Center on 1 800 12 34 56, or check the warranty information for authorized service providers in your area.	Counter({'howdoigetserviceformydishwasher': 1})
Who can I call?	Call the Customer Experience Center on 1 800 12 34 56, or check the warranty information for authorized service providers in your area.	Counter({'whocanicall': 1})